1111111111P1111111111
100C000000000000000E1
110111C111101111C1001
10000C000000000000001
111101111111111011101
100000C00C00C00000101
10C000000000000000001
110111111C11110111101
10C00000C00000C000001
111101111111111011101
10000C0000000C00000P1
111111111111111111111