11111111111111
100C00000000E1
110111111C1001
10000000000001
11110111011101
10000C00000101
10C00000B00001
11011110111101
10C0000C000001
11110111011101
1P0000C000B001
11111111111111