111111111111111111111111111
1P00010000000000001000001C1
10C001000000000000100000101
1000010000000C0000100000101
10C0010000C00000001000001C1
100000000001000100000100001
100000000001000100000100001
111010000001000100000100001
10E01000C0010001000C0100C01
111111111111111111111111111