111111111111111111111111111
1P000100000000B0001000001C1
10C001000B00000000100000101
1000010000000C0000100B00101
10C0010000C00000001000001C1
100B00000001000100000100001
100000B00001000100000100001
111010000001000100B00100001
10E01000C0010001000C0100C01
1000010000000C0000100B00101
1000010000000C0000100B00101
1000010000000C0000100B00101
1000010000000C0000100B00101
1000010000000C0000100B00101
1000010000000C0000100B00101
1000010000000C0000100B00101
1000010000000C0000100B00101
1000010000000C0000100B00101
1000010000000C0000100B00101
1000010000000C0000100B00101
1000010000000C0000100B00101
1000010000000C0000100B00101
1000010000000C0000100B00101
1000010000000C0000100B00101
1000010000000C0000100B00101
1000010000000C0000100B00101
1000010000000C0000100B00101
1000010000000C0000100B00101
1000010000000C0000100B00101
1000010000000C0000100B00101
1000010000000C0000100B00101
111111111111111111111111111